1111111111
1P00C000E0
1111111111