111111111111111111
1P0000C000000100E1
111111111111111111