11111111111
11111000001
1000CP00001
1000E000111
10C00C00001
11111111111