11111111111111111
1C0000000C00000E1
11110C00000001111
11100000C00000011
1100C001110000001
10000000111000011
1P0011000000C0111
11111111111111111